Tirana=>Albania;Tirana;
Andora=>Andora;Andora;
Wiedeñ=>Austria;Wiedeñ;
Bruksela=>Belgia;Bruksela;
Miñsk=>Bia³oruœ;Miñsk;
Sarajewo=>Boœnia i Hercegowina;Sarajewo;
Sofia=>Bu³garia;Sofia;
Zagrzeb=>Chorwacja;Zagrzeb;
Podgorica=>Czarnogóra;Podgorica;
Praga=>Czechy;Praga;
Kopenhaga=>Dania;Kopenhaga;
Tallinn=>Estonia;Tallinn;
Helsinki=>Finlandia;Helsinki;
Pary¿=>Francja;Pary¿;
Ateny=>Grecja;Ateny;
Madryt=>Hiszpania;Madryt;
Amsterdam=>Holandia;Amsterdam;
Dublin=>Irlandia;Dublin;
Reykjavík=>Islandia;Reykjavík;
Vaduz=>Liechtenstein;Vaduz;
Wilno=>Litwa;Wilno;
Luksemburg=>Luksemburg;Luksemburg;
Ryga=>£otwa;Ryga;
Skopje=>Macedonia;Skopje;
Valletta=>Malta;Valletta;
Kiszyniów=>Mo³dawia;Kiszyniów;
Monako=>Monako;Monako;
Berlin=>Niemcy;Berlin;
Oslo=>Norwegia;Oslo;
Lizbona=>Portugalia;Lizbona;
Moskwa=>Rosja;Moskwa;
Bukareszt=>Rumunia;Bukareszt;
San Marino=>San Marino;San Marino;
Belgrad=>Serbia;Belgrad;
Bratys³awa=>S³owacja;Bratys³awa;
Lublana=>S³owenia;Lublana;
Berno=>Szwajcaria;Berno;
Sztokholm=>Szwecja;Sztokholm;
Watykan=>Watykan;Watykan;
Budapeszt=>Wêgry;Budapeszt;
Londyn=>Wielka Brytania;Londyn;
Rzym=>W³ochy;Rzym;
Algier=>Algieria;Algier;
Luanda=>Angola;Luanda;
Porto-Novo=>Benin;Porto-Novo;
Gaborone=>Botswana;Gaborone;
Wagadugu=>Burkina Faso;Wagadugu;
Bu¿umbura=>Burundi;Bu¿umbura;
Nd¿amena=>Czad;Nd¿amena;
Kinszasa=>Demokratyczna Republika Konga;Kinszasa;
Kair=>Egipt;Kair;
Asmara=>Erytrea;Asmara;
Addis Abeba=>Etiopia;Addis Abeba;
Libreville=>Gabon;Libreville;
Band¿ul=>Gambia;Band¿ul;
Akra=>Ghana;Akra;
Konakry=>Gwinea;Konakry;
Bissau=>Gwinea Bissau;Bissau;
Malabo=>Gwinea Równikowa;Malabo;
Jaunde=>Kamerun;Jaunde;
Nairobi=>Kenia;Nairobi;
Moroni=>Komory;Moroni;
Brazzaville=>Kongo;Brazzaville;
Maseru=>Lesotho;Maseru;
Monrovia=>Liberia;Monrovia;
Trypolis=>Libia;Trypolis;
Antananarywa=>Madagaskar;Antananarywa;
Lilongwe=>Malawi;Lilongwe;
Bamako=>Mali;Bamako;
Rabat=>Maroko;Rabat;
Nawakszut=>Mauretania;Nawakszut;
Port Louis=>Mauritius;Port Louis;
Maputo=>Mozambik;Maputo;
Windhuk=>Namibia;Windhuk;
Niamey=>Niger;Niamey;
Abud¿a=>Nigeria;Abud¿a;
Pretoria=>Po³udniowa Afryka;Pretoria;
Bangi=>Republika Œrodkowoafrykañska;Bangi;
Praia=>Republika Zielonego Przyl¹dka;Praia;
Kigali=>Rwanda;Kigali;
Dakar=>Senegal;Dakar;
Victoria=>Seszele;Victoria;
Freetown=>Sierra Leone;Freetown;
Mogadiszu=>Somalia;Mogadiszu;
Mbabane=>Suazi;Mbabane;
Chartum=>Sudan;Chartum;
D¿uba=>Sudan Po³udniowy;D¿uba;
Dodoma=>Tanzania;Dodoma;
Lome=>Togo;Lome;
Tunis=>Tunezja;Tunis;
Kampala=>Uganda;Kampala;
Kabul=>Afganistan;Kabul;
Rijad=>Arabia Saudyjska;Rijad;
Erywañ=>Armenia;Erywañ;
Baku=>Azerbejd¿an;Baku;
Manama=>Bahrajn;Manama;
Dhaka=>Bangladesz;Dhaka;
Thimphu=>Bhutan;Thimphu;
Bandar Seri Begawan=>Brunei;Bandar Seri Begawan;
Pekin=>Chiny;Pekin;
Nikozja=>Cypr;Nikozja;
Manila=>Filipiny;Manila;
Tbilisi=>Gruzja;Tbilisi;
Delhi=>Indie;Delhi;
D¿akarta=>Indonezja;D¿akarta;
Bagdad=>Irak;Bagdad;
Teheran=>Iran;Teheran;
Tel Awiw-Jafa=>Izrael;Tel Awiw-Jafa;
Tokio=>Japonia;Tokio;
Sana=>Jemen;Sana;
Amman=>Jordania;Amman;
Phnom Penh=>Kambod¿a;Phnom Penh;
Doha=>Katar;Doha;
Astana=>Kazachstan;Astana;
Biszkek=>Kirgistan;Biszkek;
Seul=>Korea Po³udniowa;Seul;
Pjongjang=>Korea Pó³nocna;Pjongjang;
Kuwejt=>Kuwejt;Kuwejt;
Wientian=>Laos;Wientian;
Bejrut=>Liban;Bejrut;
Male=>Malediwy;Male;
Kuala Lumpur=>Malezja;Kuala Lumpur;
Naypyidaw=>Mjanma;Naypyidaw;
U³an Bator=>Mongolia;U³an Bator;
Katmandu=>Nepal;Katmandu;
Maskat=>Oman;Maskat;
Islamabad=>Pakistan;Islamabad;
Moskwa=>Rosja;Moskwa;
Singapur=>Singapur;Singapur;
Sri DŸajawardanapura Kotte=>Sri Lanka;Sri DŸajawardanapura Kotte;
Damaszek=>Syria;Damaszek;
Duszanbe=>Tad¿ykistan;Duszanbe;
Bangkok=>Tajlandia;Bangkok;
Saint John’s=>Antigua i Barbuda;Saint John’s;
Nassau=>Bahamy;Nassau;
Bridgetown=>Barbados;Bridgetown;
Belmopan=>Belize;Belmopan;
Roseau=>Dominika;Roseau;
Santo Domingo=>Dominikana;Santo Domingo;
Saint George’s=>Grenada;Saint George’s;
Gwatemala=>Gwatemala;Gwatemala;
Port-au-Prince=>Haiti;Port-au-Prince;
Tegucigalpa=>Honduras;Tegucigalpa;
Kingston=>Jamajka;Kingston;
Ottawa=>Kanada;Ottawa;
San Jose=>Kostaryka;San Jose;
Hawana=>Kuba;Hawana;
Meksyk=>Meksyk;Meksyk;
Managua=>Nikaragua;Managua;
Panama=>Panama;Panama;
Buenos Aires=>Argentyna;Buenos Aires;
Sucre=>Boliwia;Sucre;
Brasilia=>Brazylia;Brasilia;
Santiago=>Chile;Santiago;
Quito=>Ekwador;Quito;
Georgetown=>Gujana;Georgetown;
Bogota=>Kolumbia;Bogota;
Canberra=>Australia;Canberra;
Suva=>Fid¿i;Suva;
Bairiki=>Kiribati;Bairiki;
Yaren=>Nauru;Yaren;
Wellington=>Nowa Zelandia;Wellington;
Canberra=>Australia;Canberra;
Suva=>Fid¿i;Suva;
Bairiki=>Kiribati;Bairiki;
Yaren=>Nauru;Yaren;
Wellington=>Nowa Zelandia;Wellington;
Ngerulmud=>Palau;Ngerulmud;
Port Moresby=>Papua-Nowa Gwinea;Port Moresby;
Apia=>Samoa;Apia;
Palikir=>Mikronezja;Palikir;
Nuku alofa=>Tonga;Nuku alofa;
Vaiaku=>Tuvalu;Vaiaku;
Port Vila=>Vanuatu;Port Vila;
Majuro=>Wyspy Marshalla;Majuro;
Honiara=>Wyspy Salomona;Honiara;
Ngerulmud=>Palau;Ngerulmud;
Port Moresby=>Papua-Nowa Gwinea;Port Moresby;
Apia=>Samoa;Apia;
Palikir=>Mikronezja;Palikir;
Nuku alofa=>Tonga;Nuku alofa;
Vaiaku=>Tuvalu;Port Vila;
Port Vila=>Vanuatu;Port Vila;
Majuro=>Wyspy Marshalla;Majuro;
Honiara=>Wyspy SalomonaHoniara;
Asunción=>Paragwaj;Asunción;
Lima=>Peru;Lima;
Paramaribo=>Surinam;Paramaribo;
Montevideo=>Urugwaj;Montevideo;
Caracas=>Wenezuela;Caracas;
Basseterre=>Saint Kitts i Nevis;Basseterre;
Castries=>Saint Lucia;Castries;
Kingstown=>Saint Vincent i Grenadyny;Kingstown;
San Salvador=>Salwador;San Salvador;
Waszyngton=>Stany Zjednoczone;Waszyngton;
Port-of-Spain=>Trynidad i Tobago;Port-of-Spain;
Dili=>Timor Wschodni;Dili;
Ankara=>Turcja;Ankara;
Aszchabad=>Turkmenistan;Aszchabad;
Taszkent=>Uzbekistan;Taszkent;
Hanoi=>Wietnam;Hanoi;
Abu Zabi=>Zjednoczone Emiraty Arabskie;Abu Zabi;
Jamusukro=>Wybrze¿e Koœci S³oniowej;Jamusukro;
Sao Tome=>Wyspy Œwiêtego Tomasza i Ksi¹¿êca;Sao Tome;
Lusaka=>Zambia;Lusaka;
Harare=>Zimbabwe;Harare;
Warszawa=>Polska;Warszawa;

